ID,Name,Team,Position,GP,TOI,Goals,SH%,iSCF,iHDCF,Shot Attempts,Shots on Goal,Unblocked Shot Attempts,Got Blocked Attempt,Missed Net
1,A.J. Greer,BOS,L,61,555.65,5,7.58,76,36,107,66,85,22,19
2,Aaron Ekblad,FLA,D,71,1660.983333,14,6.48,136,37,376,216,282,94,66
3,Adam Boqvist,CBJ,D,46,857.1333333,5,7.35,48,7,135,68,98,37,30
4,Adam Erne,DET,L,61,816.2333333,8,14.55,69,31,114,55,85,29,30
5,Adam Fox,NYR,D,82,1998.966667,12,7.55,154,35,331,159,220,111,61
6,Adam Henrique,ANA,C,62,1127.166667,22,16.67,160,87,224,132,177,47,45
7,Adam Larsson,SEA,D,82,1938.466667,8,5.59,72,18,299,143,208,91,65
8,Adam Lowry,WPG,C,82,1283.083333,13,10.32,156,97,209,126,182,27,56
9,Adam Pelech,NYI,D,61,1320.766667,6,6.19,67,11,230,97,152,78,55
10,Adam Ruzicka,CGY,C,44,509.3333333,6,9.38,72,21,120,64,90,30,26
11,Adrian Kempe,L.A,"C, R",82,1538.15,41,16.4,244,80,451,250,342,109,92
12,Alec Martinez,VGK,D,77,1480.316667,3,3.95,54,13,197,76,117,80,41
13,Aleksander Barkov,FLA,C,68,1443.25,23,11.06,215,88,345,208,277,68,69
14,Alex Belzile,MTL,R,31,376.15,6,15,32,15,67,40,53,14,13
15,Alex Chiasson,DET,R,20,241.45,6,24,31,22,39,25,34,5,9
16,Alex DeBrincat,OTT,R,82,1558.516667,27,10.27,288,89,471,263,345,126,82
17,Alex Goligoski,MIN,D,46,812.6666667,2,3.17,25,8,116,63,75,41,12
18,Alex Iafallo,L.A,L,59,961.7,14,10.53,125,69,218,133,170,48,37
19,Alex Killorn,T.B,L,82,1411.133333,27,18.88,173,98,239,143,186,53,43
20,Alex Newhook,COL,C,82,1144.15,14,12.07,133,60,192,116,141,51,25
21,Alex Ovechkin,WSH,L,73,1474.9,42,14.29,273,94,578,294,412,166,118
22,Alex Pietrangelo,VGK,D,73,1750.633333,11,6.47,83,16,335,170,236,99,66
23,Alex Tuch,BUF,R,74,1417.266667,36,16.51,215,93,363,218,307,56,89
24,Alex Wennberg,SEA,C,82,1532.866667,13,12.87,124,83,165,101,136,29,35
25,Alexander Alexeyev,WSH,D,32,526.55,0,0,15,5,72,28,51,21,23
26,Alexander Barabanov,S.J,L,68,1227.616667,15,12.5,166,95,217,120,168,49,48
27,Alexander Edler,L.A,D,64,945.5666667,2,3.57,40,2,154,56,90,64,34
28,Alexander Kerfoot,TOR,C,82,1198.75,10,7.52,148,72,221,133,177,44,44
29,Alexander Romanov,NYI,D,76,1478.166667,2,2,55,9,235,100,134,101,34
30,Alexandre Carrier,NSH,D,43,769.2,2,4.17,31,6,99,48,67,32,19
31,Alexey Toropchenko,STL,R,69,833.2666667,10,11.63,85,49,129,86,103,26,17
32,Alexis Lafrenière,NYR,L,81,1232.783333,16,11.85,148,75,239,135,183,56,48
33,Aliaksei Protas,WSH,C,58,668.0166667,4,4.82,82,43,139,83,105,34,22
34,Anders Lee,NYI,L,82,1412.283333,28,13.08,267,184,336,214,303,33,89
35,Andre Burakovsky,SEA,L,49,811.1333333,13,12.38,103,24,206,105,147,59,42
36,Andreas Athanasiou,CHI,C,81,1296.283333,20,11.43,180,81,337,175,259,78,84
37,Andreas Englund,"CHI, COL",D,47,569.2333333,0,0,13,4,72,31,52,20,21
38,Andrei Kuzmenko,VAN,L,81,1315.583333,39,27.27,209,119,276,143,210,66,67
39,Andrei Svechnikov,CAR,R,64,1155.083333,23,11.22,227,88,411,205,318,93,113
40,Andrew Cogliano,COL,C,79,996.8,10,11.76,69,33,131,85,104,27,19
41,Andrew Copp,DET,C,82,1488.716667,9,7.5,120,52,204,120,162,42,42
42,Andrew Mangiapane,CGY,L,82,1379.383333,17,9.34,247,118,343,182,256,87,74
43,Andrew Peeke,CBJ,D,80,1699.75,6,6.67,42,5,188,90,126,62,36
44,Anthony Beauvillier,"NYI, VAN",L,82,1333.866667,18,10.23,210,88,285,176,233,52,57
45,Anthony Cirelli,T.B,C,58,960.5333333,11,9.91,135,84,189,111,155,34,44
46,Anthony Duclair,FLA,L,20,297.0333333,2,4.65,53,31,83,43,66,17,23
47,Anthony Mantha,WSH,R,67,952.6333333,11,9.24,131,58,203,119,156,47,37
48,Anton Lundell,FLA,C,73,1195.05,12,7.89,143,68,261,152,196,65,44
49,Anze Kopitar,L.A,C,82,1664.783333,28,16.57,186,94,290,169,239,51,70
50,Arber Xhekaj,MTL,D,51,778.8,5,6.67,32,4,169,75,103,66,28
51,Artem Zub,OTT,D,53,1073.416667,3,7.32,29,4,109,41,63,46,22
52,Artemi Panarin,NYR,L,82,1607.833333,29,14.22,220,48,430,204,306,124,102
53,Arthur Kaliyev,L.A,R,56,653.95,13,10.66,142,62,227,122,169,58,47
54,Artturi Lehkonen,COL,L,64,1308.95,21,14,192,101,276,150,213,63,63
55,Austin Czarnik,DET,C,29,324,3,11.11,26,14,47,27,37,10,10
56,Austin Watson,OTT,L,75,767.4666667,9,11.39,75,39,139,79,115,24,36
57,Auston Matthews,TOR,C,74,1500.6,40,12.23,393,167,568,327,453,115,126
58,Axel Jonsson-Fjallby,WPG,L,50,522.8,6,11.11,56,17,98,54,74,24,20
59,Barclay Goodrow,NYR,C,82,1162,11,12.36,104,58,158,89,123,35,34
60,Barrett Hayton,ARI,C,82,1434.816667,19,10.67,199,104,279,178,235,44,57
61,Ben Chiarot,DET,D,76,1566.183333,5,4.55,56,7,231,110,155,76,45
62,Ben Harpur,NYR,D,42,590.7,1,2.94,17,1,77,34,47,30,13
63,Ben Hutton,VGK,D,31,495.8166667,3,5.77,24,8,94,52,66,28,14
64,Ben Meyers,COL,C,39,374.2666667,4,11.76,45,30,61,34,48,13,14
65,Blake Coleman,CGY,C,82,1246.65,18,9.57,223,120,331,188,264,67,76
66,Blake Lizotte,L.A,C,81,1048.45,11,10.19,109,62,175,108,152,23,44
67,Blake Wheeler,WPG,R,72,1227.183333,16,12.7,161,83,254,126,198,56,72
68,Bo Horvat,"NYI, VAN",C,79,1631.666667,38,16.59,254,125,355,229,301,54,72
69,Boone Jenner,CBJ,C,68,1374.1,26,12.15,241,147,386,214,316,70,102
70,Boris Katchouk,CHI,L,58,701.2,5,7.35,74,31,138,68,103,35,35
71,Bowen Byram,COL,D,42,918.8666667,10,15.38,60,13,140,65,95,45,30
72,Brad Hunt,COL,D,47,527.0666667,4,8.7,20,2,97,46,67,30,21
73,Brad Marchand,BOS,L,73,1352.55,21,11.48,211,76,335,183,250,85,67
74,Braden Schneider,NYR,D,81,1273.466667,5,6.33,48,8,169,79,103,66,24
75,Brady Skjei,CAR,D,81,1766.483333,18,9.57,127,26,411,188,285,126,97
76,Brady Tkachuk,OTT,L,82,1527.833333,35,10.09,383,240,559,347,486,73,139
77,Brandon Carlo,BOS,D,75,1412.3,3,3.19,62,14,174,94,127,47,33
78,Brandon Duhaime,MIN,R,51,548.6,9,11.25,85,46,139,80,115,24,35
79,Brandon Hagel,T.B,L,81,1510.4,30,16.85,233,121,306,178,245,61,67
80,Brandon Montour,FLA,D,80,1930.1,16,6.61,156,45,459,242,339,120,97
81,Brandon Saad,STL,L,71,1182.5,19,14.96,144,72,198,127,167,31,40
82,Brandon Tanev,SEA,L,82,1166.05,16,13.91,117,73,192,115,166,26,51
83,Brayden McNabb,VGK,D,82,1627.183333,1,1.12,56,7,219,89,130,89,41
84,Brayden Point,T.B,C,82,1612.916667,51,21.7,343,193,393,235,320,73,85
85,Brayden Schenn,STL,C,82,1511.2,21,14.58,184,75,284,144,214,70,70
86,Brendan Gallagher,MTL,R,37,528.4166667,8,8.6,103,44,177,93,124,53,31
87,Brendan Lemieux,"L.A, PHI",L,45,458.1666667,2,4.55,42,21,79,44,58,21,14
88,Brendan Smith,N.J,D,60,933.2,0,0,57,14,128,58,82,46,24
89,Brenden Dillon,WPG,D,82,1606.25,2,2.41,48,6,204,83,126,78,43
90,Brent Burns,CAR,D,82,1903.65,18,7.06,154,24,554,255,366,188,111
91,Brett Howden,VGK,C,54,705.1833333,6,11.32,76,35,108,53,83,25,30
92,Brett Kulak,EDM,D,82,1435.766667,3,2.63,40,8,211,114,143,68,29
93,Brett Leason,ANA,R,54,588.1666667,6,11.76,55,22,101,51,78,23,27
94,Brett Pesce,CAR,D,82,1804.783333,5,3.47,78,12,346,144,216,130,72
95,Brett Ritchie,"ARI, CGY",R,50,502.5166667,8,11.76,53,22,111,68,89,22,21
96,Brian Dumoulin,PIT,D,82,1692.55,1,1.22,61,11,189,82,120,69,38
97,Brock Boeser,VAN,R,74,1275.866667,18,10.11,206,99,309,178,243,66,65
98,Brock McGinn,"ANA, PIT",L,75,977.55,12,13.19,90,41,156,91,130,26,39
99,Brock Nelson,NYI,C,82,1511.7,36,16.22,271,112,418,222,298,120,76
100,Bryan Rust,PIT,R,81,1449.866667,20,9.48,248,139,364,211,301,63,90
101,Cal Clutterbuck,NYI,R,49,598.9666667,6,13.64,49,24,79,44,65,14,21
102,Cal Foote,"NSH, T.B",D,50,756.1166667,2,5.13,19,2,84,39,58,26,19
103,Cale Makar,COL,D,60,1582.816667,17,9.66,137,29,403,176,258,145,82
104,Caleb Jones,CHI,D,73,1402.3,4,4.65,68,15,197,86,127,70,41
105,Calen Addison,MIN,D,62,999.4333333,3,3.9,29,4,155,77,106,49,29
106,Calle Jarnkrok,TOR,C,73,1049.916667,20,18.87,134,61,197,106,153,44,47
107,Calle Rosen,STL,D,49,764.4666667,8,12.9,39,3,115,62,81,34,19
108,Calvin de Haan,CAR,D,53,717.25,2,3.92,48,10,153,51,102,51,51
109,Cam Fowler,ANA,D,82,1982.216667,10,7.69,99,19,294,130,181,113,51
110,Cam York,PHI,D,54,1060.866667,2,4.76,53,14,122,42,78,44,36
111,Carl Grundstrom,L.A,R,57,612.8666667,12,13.33,96,52,169,90,132,37,42
112,Carson Soucy,SEA,D,78,1270.766667,3,3.45,52,7,196,87,130,66,43
113,Carter Verhaeghe,FLA,C,81,1417.666667,42,15.27,284,119,470,275,353,117,78
114,Casey Cizikas,NYI,C,81,1177.45,6,5.41,119,66,189,111,149,40,38
115,Casey Fitzgerald,"BUF, FLA",D,27,321.7333333,0,0,10,2,42,13,24,18,11
116,Casey Mittelstadt,BUF,C,82,1289.716667,15,11.11,146,55,228,135,178,50,43
117,Chad Ruhwedel,PIT,D,47,684.7166667,1,2.78,23,4,97,36,59,38,23
118,Chandler Stephenson,VGK,C,81,1540.383333,16,13.33,138,77,203,120,165,38,45
119,Charlie Coyle,BOS,C,82,1392.883333,16,11.43,164,83,241,140,191,50,51
120,Charlie McAvoy,BOS,D,67,1494.3,7,6.67,88,20,225,105,143,82,38
121,Chris Kreider,NYR,L,79,1454.633333,36,15.72,283,196,382,229,335,47,106
122,Chris Tanev,CGY,D,65,1307.816667,1,1.33,23,2,163,75,99,64,24
123,Chris Tierney,"FLA, MTL",C,36,391.0666667,3,15.79,19,4,36,19,28,8,9
124,Chris Wideman,MTL,D,46,621.55,0,0,14,2,67,31,45,22,14
125,Christian Dvorak,MTL,C,64,1079.083333,10,11.36,102,55,144,88,115,29,27
126,Christian Fischer,ARI,R,80,1187.583333,13,10.66,100,45,203,122,162,41,40
127,Christian Wolanin,VAN,D,16,252.1,0,0,9,2,34,16,23,11,7
128,Claude Giroux,OTT,R,82,1541.266667,35,16.36,199,95,357,214,293,64,79
129,Clayton Keller,ARI,R,82,1701.516667,37,16.52,217,69,383,224,302,81,78
130,Cody Ceci,EDM,D,80,1610.75,1,1.14,58,13,192,88,124,68,36
131,Cody Glass,NSH,C,72,1063.233333,14,10.69,156,77,230,131,185,45,54
132,Cole Caufield,MTL,R,46,830.2833333,26,16.46,151,46,294,158,228,66,70
133,Cole Guttman,CHI,C,14,203.85,4,15.38,23,8,42,26,30,12,4
134,Cole Perfetti,WPG,C,51,763.4333333,8,8.89,108,44,159,90,122,37,32
135,Cole Sillinger,CBJ,C,64,851.7833333,3,3.23,111,48,179,93,137,42,44
136,Cole Smith,NSH,L,69,879.2333333,4,6.25,87,47,118,64,97,21,33
137,Colin Blackwell,CHI,C,53,625.45,2,3.77,49,21,99,53,72,27,19
138,Colin Miller,DAL,D,79,1325,6,5.66,78,9,273,106,170,103,64
139,Colin White,FLA,C,68,655.2,8,12.5,72,32,114,64,89,25,25
140,Colton Parayko,STL,D,79,1817.216667,4,3.01,59,10,256,133,183,73,50
141,Colton Sissons,NSH,C,82,1297.85,12,13.79,106,52,179,87,136,43,49
142,Colton White,ANA,D,46,668.3833333,0,0,18,6,57,30,39,18,9
143,Connor Clifton,BOS,D,78,1392.75,5,5.38,59,16,172,93,137,35,44
144,Connor Dewar,MIN,C,81,887.9166667,6,6.9,99,44,169,87,124,45,37
145,Connor Mackey,"ARI, CGY",D,30,421.4166667,3,9.68,13,1,64,31,46,18,15
146,Connor McDavid,EDM,C,82,1835.616667,64,18.18,379,164,529,352,441,88,89
147,Connor Murphy,CHI,D,80,1551.2,7,8.24,41,9,177,85,112,65,27
148,Conor Garland,VAN,R,81,1224.216667,17,10.18,167,58,280,167,234,46,67
149,Conor Sheary,WSH,L,82,1292.766667,15,9.74,160,75,259,154,217,42,63
150,Conor Timmins,"ARI, TOR",D,27,407.4333333,2,10.53,16,0,52,19,27,25,8
151,Corey Perry,T.B,R,81,936.55,12,10.34,139,86,194,116,165,29,49
152,Craig Smith,"BOS, WSH",C,64,703.9833333,9,8.65,103,47,178,104,132,46,28
153,Curtis Lazar,"N.J, VAN",C,49,584.5666667,3,5.45,51,38,86,55,69,17,14
154,Dakota Joshua,VAN,C,79,910.2,11,15.49,82,59,106,71,90,16,19
155,Damon Severson,N.J,D,81,1616.35,7,6.86,90,19,245,102,146,99,44
156,Daniel Sprong,SEA,R,66,753.65,21,14.29,115,35,280,147,211,69,64
157,Daniil Miromanov,VGK,D,14,238.4833333,2,9.09,18,1,47,22,28,19,6
158,Dante Fabbro,NSH,D,79,1378.35,2,1.98,52,8,204,101,133,71,32
159,Danton Heinen,PIT,L,65,699.2333333,8,8.33,94,40,163,96,125,38,29
160,Darnell Nurse,EDM,D,82,1926.65,12,5.91,124,24,401,203,272,129,69
161,Darren Raddysh,T.B,D,17,280.1833333,1,4,20,1,47,25,31,16,6
162,David Gustafsson,WPG,C,46,464.4833333,0,0,42,21,72,45,55,17,10
163,David Kampf,TOR,C,82,1255.216667,7,6.54,113,60,171,107,140,31,33
164,David Krejci,BOS,C,70,1203.616667,16,14.29,132,57,202,112,156,46,44
165,David Pastrnak,BOS,R,82,1604.283333,61,14.99,374,120,727,407,541,186,134
166,David Perron,DET,L,82,1387.316667,24,12.31,194,64,350,195,267,83,72
167,David Savard,MTL,D,62,1388,3,4.76,40,10,123,63,82,41,19
168,Dawson Mercer,N.J,C,82,1357.95,27,16.77,193,106,274,161,216,58,55
169,Denis Gurianov,"DAL, MTL",R,66,870.95,7,6.03,101,50,227,116,168,59,52
170,Denis Malgin,"COL, TOR",C,65,709.7666667,13,11.61,128,50,198,112,150,48,38
171,Dennis Gilbert,CGY,D,23,270,1,7.69,8,1,36,13,22,14,9
172,Derek Forbort,BOS,D,54,957.5333333,5,13.16,25,2,103,38,55,48,17
173,Derek Grant,ANA,C,46,682.9,5,6.94,59,35,123,72,98,25,26
174,Derek Ryan,EDM,C,80,893.2833333,13,14.13,106,68,150,92,122,28,30
175,Derek Stepan,CAR,C,73,662.8833333,5,5.1,92,47,178,98,144,34,46
176,Derick Brassard,OTT,C,62,755.1833333,13,14.13,98,58,139,92,117,22,25
177,Devin Shore,EDM,C,47,421.35,1,3.03,44,19,61,33,48,13,15
178,Devon Toews,COL,D,80,2008.5,7,4.24,95,25,309,165,214,95,49
179,Dillon Dube,CGY,C,82,1243.2,18,11.92,183,78,267,151,207,60,56
180,Dmitry Kulikov,"ANA, PIT",D,67,1304.766667,3,3.57,46,12,148,84,105,43,21
181,Dmitry Orlov,"BOS, WSH",D,66,1488,7,5.65,87,19,238,124,162,76,38
182,Dominik Kubalik,DET,L,81,1208,20,11.49,173,65,315,174,244,71,70
183,Dougie Hamilton,N.J,D,82,1785.5,22,8,215,35,562,275,378,184,103
184,Drake Batherson,OTT,R,82,1525.7,22,8.84,293,133,443,249,362,81,113
185,Drew Doughty,L.A,D,81,2124.55,9,6.21,100,21,290,145,199,91,54
186,Drew O'Connor,PIT,L,46,451.5166667,5,8.06,68,36,120,62,91,29,29
187,Dryden Hunt,"COL, NYR, TOR",L,37,298.7166667,3,13.04,23,13,42,23,33,9,10
188,Dylan Coghlan,CAR,D,17,216.25,0,0,18,2,66,29,44,22,15
189,Dylan Cozens,BUF,C,81,1336.25,31,14.69,240,101,336,211,274,62,63
190,Dylan DeMelo,WPG,D,75,1467.066667,6,6.45,51,11,194,93,136,58,43
191,Dylan Gambrell,OTT,C,60,683.3333333,4,8.7,52,24,87,46,65,22,19
192,Dylan Guenther,ARI,R,33,432.7,6,11.32,60,16,108,53,74,34,21
193,Dylan Holloway,EDM,L,51,488.85,3,6.82,57,30,83,44,68,15,24
194,Dylan Larkin,DET,C,80,1564.45,32,13.11,269,99,465,244,348,117,104
195,Dylan Samberg,WPG,D,63,940.3333333,2,4.08,27,3,117,49,68,49,19
196,Dylan Strome,WSH,C,81,1351.65,23,14.94,200,103,275,154,220,55,66
197,Eeli Tolvanen,"NSH, SEA",R,61,885.5,18,15.52,97,37,218,116,168,50,52
198,Eetu Luostarinen,FLA,C,82,1310.833333,17,12.88,190,100,244,132,188,56,56
199,Elias Lindholm,CGY,C,80,1492.116667,22,11.76,217,95,342,187,266,76,79
200,Elias Pettersson,VAN,C,80,1644.383333,39,15.18,276,101,489,257,373,116,116
201,Elmer Soderblom,DET,L,21,253.5333333,5,16.67,31,20,46,30,36,10,6
202,Emil Bemstrom,CBJ,R,55,665.9666667,7,7.37,104,44,180,95,134,46,39
203,Eric Robinson,CBJ,L,72,1004.25,12,12.12,108,57,190,99,134,56,35
204,Eric Staal,FLA,C,72,1025.066667,14,13.21,119,65,183,106,142,41,36
205,Erik Brannstrom,OTT,D,74,1192.4,2,2.7,69,11,200,74,110,90,36
206,Erik Cernak,T.B,D,70,1346.816667,2,2.3,54,7,166,87,120,46,33
207,Erik Gudbranson,CBJ,D,70,1490.933333,1,0.98,46,6,215,102,141,74,39
208,Erik Gustafsson,"TOR, WSH",D,70,1384.1,7,5.74,88,19,269,122,188,81,66
209,Erik Haula,N.J,L,80,1330.483333,14,8.54,182,99,295,164,236,59,72
210,Erik Johnson,COL,D,63,1087.033333,0,0,57,13,182,98,126,56,28
211,Erik Karlsson,S.J,D,82,2100.433333,25,11.96,202,34,505,209,287,218,78
212,Esa Lindell,DAL,D,82,1633.183333,8,6.9,68,13,231,116,149,82,33
213,Ethan Bear,VAN,D,61,1130.15,3,4,40,10,155,75,106,49,31
214,Evan Bouchard,EDM,D,82,1518.35,8,5.13,100,12,380,156,219,161,63
215,Evan Rodrigues,COL,C,69,1232.083333,16,8.7,175,74,311,184,235,76,51
216,Evander Kane,EDM,L,41,766.8333333,16,10.96,164,70,258,146,190,68,44
217,Evgeni Malkin,PIT,C,82,1523.6,27,11.25,262,102,417,240,313,104,73
218,Evgenii Dadonov,"DAL, MTL",R,73,1074.85,7,6.36,116,68,204,110,152,52,42
219,Evgeny Kuznetsov,WSH,C,81,1462.816667,12,6.98,169,57,320,172,241,79,69
220,Evgeny Svechnikov,S.J,L,59,634.1166667,8,12.5,81,45,122,64,94,28,30
221,Fabian Zetterlund,"N.J, S.J",L,67,888.2166667,6,5.08,123,51,223,118,166,57,48
222,Filip Chytil,NYR,C,74,1086.6,22,12.43,201,88,312,177,243,69,66
223,Filip Forsberg,NSH,L,50,873.6,19,12.1,173,67,322,157,242,80,85
224,Filip Hronek,"DET, VAN",D,64,1388.783333,9,7.26,61,9,259,124,168,91,44
225,Filip Roos,CHI,D,17,275.7666667,1,5.26,12,1,43,19,27,16,8
226,Filip Zadina,DET,R,30,392.9,3,5.88,53,20,82,51,67,15,16
227,Frank Vatrano,ANA,R,81,1350.966667,22,9.52,182,77,354,231,293,61,62
228,Frederick Gaudreau,MIN,C,82,1315.516667,19,13.77,117,51,207,138,168,39,30
229,Fredrik Olofsson,DAL,L,28,285.75,1,2.94,32,17,58,34,45,13,11
230,Gabriel Vilardi,L.A,"C, R",63,983.0166667,23,18.85,156,83,207,122,161,46,39
231,Garnet Hathaway,"BOS, WSH",R,84,990.8,13,14.77,97,60,151,88,119,32,31
232,Gavin Bayreuther,CBJ,D,51,813.3,2,3.28,27,5,118,61,74,44,13
233,Givani Smith,"DET, FLA",R,36,252.15,1,3.33,27,17,60,30,43,17,13
234,Guillaume Brisebois,VAN,D,17,281.1666667,1,6.67,7,1,24,15,21,3,6
235,Gustav Forsling,FLA,D,82,1921.733333,13,6.22,120,16,413,209,275,138,66
236,Gustav Lindstrom,DET,D,36,510.1,1,5.56,17,4,49,18,30,19,12
237,Gustav Nyquist,"CBJ, MIN","C, L",51,898.6,11,10.78,100,48,164,102,133,31,31
238,Hampus Lindholm,BOS,D,80,1854.95,10,6.33,107,25,300,158,203,97,45
239,Haydn Fleury,T.B,D,29,370.9833333,0,0,25,8,70,33,51,19,18
240,Henri Jokiharju,BUF,D,60,1261.466667,3,3.8,31,1,153,79,103,50,24
241,Hudson Fasching,NYI,R,49,611.65,10,16.39,78,51,109,61,79,30,18
242,Ian Cole,T.B,D,78,1512.133333,3,2.75,66,14,218,109,147,71,38
243,Ian Mitchell,CHI,D,35,554.3666667,1,4,16,0,50,25,33,17,8
244,Ilya Lyubushkin,BUF,D,68,1020.6,2,4.88,18,2,78,41,52,26,11
245,Ilya Mikheyev,VAN,R,46,777.9666667,13,14.29,96,47,138,91,112,26,21
246,Isaak Phillips,CHI,D,16,247.3666667,1,6.25,8,5,37,16,25,12,9
247,Isac Lundestrom,ANA,C,61,874.3666667,4,6.67,70,38,104,60,81,23,21
248,Ivan Barbashev,"STL, VGK",C,82,1374,16,12.7,169,89,218,126,177,41,51
249,Ivan Provorov,PHI,D,82,1887.866667,6,5.22,80,16,256,115,173,83,58
250,J.J. Moser,ARI,D,82,1726.15,7,7.53,70,13,213,93,128,85,35
251,J.T. Compher,COL,L,82,1684.333333,17,11.04,191,86,255,154,209,46,55
252,J.T. Miller,VAN,C,81,1675.05,32,14.35,233,88,404,223,311,93,88
253,Jaccob Slavin,CAR,D,76,1671.366667,7,5.34,103,22,297,131,198,99,67
254,Jack Drury,CAR,C,38,409.8333333,2,2.9,68,36,109,69,88,21,19
255,Jack Eichel,VGK,C,67,1257.383333,27,12.11,168,63,359,223,283,76,60
256,Jack Hughes,N.J,C,78,1557.35,43,12.8,342,119,554,336,422,132,86
257,Jack Johnson,"CHI, COL",D,83,1588.883333,2,2.17,38,10,173,92,117,56,25
258,Jack McBain,ARI,C,82,1146.45,12,14.12,108,60,151,85,119,32,34
259,Jack Quinn,BUF,R,75,1038.533333,14,11.11,175,67,257,126,186,71,60
260,Jack Roslovic,CBJ,C,77,1266.383333,11,8.94,129,50,218,123,164,54,41
261,Jack Studnicka,"BOS, VAN",C,48,508.55,4,6.15,64,33,108,65,85,23,20
262,Jacob Bernard-Docker,OTT,D,19,304.3166667,0,0,12,4,47,22,34,13,12
263,Jacob Bryson,BUF,D,59,860.5833333,1,3.7,13,0,58,27,40,18,13
264,Jacob MacDonald,"COL, S.J",D,58,698.2833333,1,1.33,67,24,140,75,104,36,29
265,Jacob Peterson,"DAL, S.J",C,12,209.2666667,2,9.52,31,9,44,21,34,10,13
266,Jacob Trouba,NYR,D,82,1738.05,8,4.02,96,19,362,199,252,110,53
267,Jaden Schwartz,SEA,C,71,1237.05,21,12.57,189,97,291,167,221,70,54
268,Jake Bean,CBJ,D,14,219.85,1,6.25,10,2,32,16,21,11,5
269,Jake Christiansen,CBJ,D,24,365.3166667,0,0,15,3,55,25,41,14,16
270,Jake DeBrusk,BOS,L,64,1073.7,27,14.14,207,131,298,191,245,53,54
271,Jake Evans,MTL,C,54,782.4666667,2,3.64,62,30,107,55,72,35,17
272,Jake Guentzel,PIT,L,78,1569.05,36,14.75,331,176,446,244,344,102,100
273,Jake Leschyshyn,"NYR, VGK",C,35,319.5,0,0,34,21,46,31,36,10,5
274,Jake McCabe,"CHI, TOR",D,76,1480.1,3,3.13,52,14,185,96,135,50,39
275,Jake Middleton,MIN,D,79,1504.1,3,3.8,52,17,177,79,122,55,43
276,Jake Neighbours,STL,L,43,534.3833333,6,11.32,56,28,87,53,72,15,19
277,Jake Sanderson,OTT,D,77,1687.866667,4,3.03,76,12,279,132,192,87,60
278,Jake Walman,DET,D,63,1242.266667,9,6.43,75,12,257,140,183,74,43
279,Jakob Chychrun,"ARI, OTT",D,48,1089.783333,9,6.25,95,20,281,144,205,76,61
280,Jakob Pelletier,CGY,L,24,340.4333333,3,6.25,60,30,84,48,67,17,19
281,Jakob Silfverberg,ANA,R,81,1229.516667,10,7.09,105,48,230,141,190,40,49
282,Jakub Lauko,BOS,C,23,203.8833333,4,23.53,26,8,33,17,25,8,8
283,Jakub Vrana,"DET, STL",L,25,363.75,11,17.46,65,24,107,63,86,21,23
284,Jakub Zboril,BOS,D,22,292.3666667,1,7.69,9,2,31,13,21,10,8
285,Jalen Chatfield,CAR,D,78,1101.733333,6,6.45,58,15,215,93,146,69,53
286,James van Riemsdyk,PHI,L,61,936.5833333,12,10.08,129,87,197,119,162,35,43
287,Jamie Benn,DAL,L,82,1294.25,33,17.37,211,105,330,190,252,78,62
288,Jamie Oleksiak,SEA,D,75,1443.85,9,11.84,54,10,161,76,109,52,33
289,Jan Rutta,PIT,D,56,958.7333333,3,4.69,29,2,140,64,90,50,26
290,Jani Hakanpää,DAL,D,82,1585.133333,6,6.98,52,11,211,86,130,81,44
291,Jansen Harkins,WPG,C,22,238.0333333,3,16.67,24,12,40,18,25,15,7
292,Jared McCann,SEA,L,79,1290.8,40,19.05,178,57,396,210,287,109,77
293,Jared Spurgeon,MIN,D,79,1723.15,11,7.38,100,30,290,149,212,78,63
294,Jaret Anderson-Dolan,L.A,C,46,488.4,7,12.96,47,29,79,54,68,11,14
295,Jarred Tinordi,CHI,D,44,724.1333333,2,6.25,18,3,78,32,52,26,20
296,Jason Dickinson,CHI,C,78,1243.233333,9,7.89,120,56,209,114,155,54,41
297,Jason Robertson,DAL,L,82,1544.783333,46,14.7,307,107,565,313,412,153,99
298,Jason Zucker,PIT,L,78,1221.166667,27,13.71,220,131,338,197,283,55,86
299,Jaycob Megna,"S.J, SEA",D,54,1018.766667,1,1.79,36,7,126,56,78,48,22
300,Jayson Megna,"ANA, COL",C,55,550.2333333,2,5.56,38,17,64,36,53,11,17
301,Jean-Gabriel Pageau,NYI,C,70,1232.883333,13,10.57,139,78,204,123,173,31,50
302,Jeff Carter,PIT,C,79,1082.8,13,9.35,141,75,240,139,184,56,45
303,Jeff Petry,PIT,D,61,1362.933333,5,4.42,55,7,253,113,163,90,50
304,Jeff Skinner,BUF,L,79,1374.383333,35,14.46,289,145,433,242,330,103,88
305,Jeremy Lauzon,NSH,D,67,1128.4,3,3.9,46,7,162,77,112,50,35
306,Jesper Boqvist,N.J,C,70,812.4,10,14.93,89,47,135,67,94,41,27
307,Jesper Bratt,N.J,L,82,1424.133333,32,15.09,249,101,381,212,303,78,91
308,Jesper Fast,CAR,R,80,1178.516667,10,13.16,116,74,152,76,125,27,49
309,Jesperi Kotkaniemi,CAR,C,82,1208.35,18,13.95,157,83,243,129,184,59,55
310,Jesse Puljujarvi,"CAR, EDM",R,75,917.3833333,5,4,134,59,227,125,178,49,53
311,Jesse Ylonen,MTL,R,37,497.5333333,6,13.95,39,14,80,43,53,27,10
312,Jimmy Vesey,NYR,L,81,1102.45,11,8.94,128,67,206,123,162,44,39
313,JJ Peterka,BUF,R,77,1050.833333,12,9.6,133,62,238,125,180,58,55
314,Joe Pavelski,DAL,C,82,1453.266667,28,15.14,254,152,338,185,263,75,78
315,Joe Veleno,DET,C,81,1034.85,9,10.59,88,41,146,85,105,41,20
316,Joel Armia,MTL,R,43,642.6833333,7,10.14,78,35,126,69,99,27,30
317,Joel Edmundson,MTL,D,61,1193.5,2,2.9,17,5,126,69,92,34,23
318,Joel Eriksson Ek,MIN,C,78,1481.583333,23,9.31,252,173,397,247,336,61,89
319,Joel Farabee,PHI,L,82,1394.883333,15,10.34,149,65,258,145,192,66,47
320,Joel Hanley,DAL,D,26,302.5666667,0,0,8,1,31,14,23,8,9
321,Joel Kiviranta,DAL,L,70,850.8,8,9.41,88,43,144,85,113,31,28
322,Joey Anderson,"CHI, TOR",R,38,444.5,6,14.63,43,21,90,41,70,20,29
323,John Carlson,WSH,D,40,935.5833333,9,7.26,91,10,261,124,193,68,69
324,John Klingberg,"ANA, MIN",D,67,1381.616667,10,8.93,88,12,272,112,171,101,59
325,John Marino,N.J,D,64,1348.533333,4,5.97,47,11,145,67,91,54,24
326,John Tavares,TOR,C,80,1412.516667,36,13,370,224,464,277,392,72,115
327,Johnathan Kovacevic,MTL,D,77,1341.3,3,3.26,58,9,204,92,132,72,40
328,Johnny Gaudreau,CBJ,L,80,1553.45,21,9.55,226,75,398,220,308,90,88
329,Jon Merrill,MIN,D,73,1105.616667,2,4.65,22,4,99,43,74,25,31
330,Jonah Gadjovich,S.J,L,35,314.7,3,9.38,39,27,55,32,46,9,14
331,Jonas Brodin,MIN,D,60,1371.85,3,3.33,41,9,180,90,125,55,35
332,Jonas Siegenthaler,N.J,D,80,1612.316667,4,4.76,50,5,189,84,136,53,52
333,Jonatan Berggren,DET,R,67,901.8,15,15.31,85,39,158,98,133,25,35
334,Jonathan Drouin,MTL,L,58,864.6666667,2,2.9,69,29,125,69,90,35,21
335,Jonathan Huberdeau,CGY,C,79,1332.266667,15,11.9,150,70,233,126,185,48,59
336,Jonathan Marchessault,VGK,"C, R",76,1302.666667,28,11.97,232,78,432,234,320,112,86
337,Jonathan Toews,CHI,C,53,938.6666667,15,17.24,87,50,138,87,113,25,26
338,Jordan Eberle,SEA,R,82,1368.116667,20,11.3,202,76,321,177,246,75,69
339,Jordan Greenway,"BUF, MIN",L,62,837.3,6,6.06,107,54,190,99,142,48,43
340,Jordan Gross,NSH,D,15,281.7,3,12.5,20,3,56,24,38,18,14
341,Jordan Harris,MTL,D,65,1212.4,4,5.71,56,14,158,70,95,63,25
342,Jordan Kyrou,STL,C,79,1422.283333,37,13.6,280,71,470,272,359,111,87
343,Jordan Martinook,CAR,L,82,1281.883333,13,8.02,190,101,306,162,248,58,86
344,Jordan Oesterle,DET,D,52,814.1,2,3.7,35,4,105,54,75,30,21
345,Jordan Staal,CAR,C,81,1317.716667,17,13.71,151,84,201,124,171,30,47
346,Josh Anderson,MTL,R,69,1170.233333,21,12.8,199,96,281,164,230,51,66
347,Josh Archibald,PIT,R,62,618.5666667,6,8.45,67,40,112,71,95,17,24
348,Josh Bailey,NYI,R,64,968.5,8,11.11,83,32,115,72,94,21,22
349,Josh Brown,ARI,D,68,1071.85,4,5.88,40,13,128,68,105,23,37
350,Josh Leivo,STL,L,51,606.45,4,4.4,92,44,163,91,126,37,35
351,Josh Mahura,FLA,D,82,1151.266667,4,5.13,52,7,197,78,119,78,41
352,Josh Manson,COL,D,27,477.5666667,2,4.88,23,10,71,41,51,20,10
353,Josh Morrissey,WPG,D,78,1890.033333,16,9.3,139,30,395,172,265,130,93
354,Jujhar Khaira,CHI,L,51,707.8166667,6,10.17,70,38,111,59,86,25,27
355,Julien Gauthier,"NYR, OTT",R,57,492.1666667,9,16.98,58,26,94,53,73,21,20
356,Juraj Slafkovsky,MTL,L,39,476.4,4,9.52,45,15,92,42,61,31,19
357,Justin Barron,MTL,D,39,635.8333333,4,10,27,4,93,40,52,41,12
358,Justin Braun,PHI,D,51,764.1166667,0,0,27,0,100,42,68,32,26
359,Justin Faulk,STL,D,82,1916.933333,11,5.61,116,27,352,196,253,99,57
360,Justin Holl,TOR,D,80,1619.316667,2,3.33,35,13,109,60,75,34,15
361,Justin Schultz,SEA,D,73,1298.633333,7,7.14,61,15,215,98,130,85,32
362,Juuso Parssinen,NSH,C,45,645,6,12.24,68,41,92,49,75,17,26
363,Juuso Valimaki,ARI,D,78,1417.666667,4,4.3,81,22,194,93,135,59,42
364,K'Andre Miller,NYR,D,79,1734.216667,9,7.96,82,19,240,113,164,76,51
365,Kaapo Kakko,NYR,R,82,1255.166667,18,14.29,148,72,226,126,177,49,51
366,Kaiden Guhle,MTL,D,44,902.7,4,8.33,40,8,107,48,65,42,17
367,Kailer Yamamoto,EDM,R,58,961.5333333,10,10.31,114,73,138,97,117,21,20
368,Kale Clague,BUF,D,33,498.4333333,0,0,16,3,51,24,32,19,8
369,Karson Kuhlman,"SEA, WPG",C,47,556.65,3,6.25,66,30,114,48,77,37,29
370,Kasperi Kapanen,"PIT, STL",R,66,903.15,15,12.93,90,29,175,116,144,31,28
371,Keegan Kolesar,VGK,R,74,849.0666667,8,12.7,79,51,113,63,87,26,24
372,Kent Johnson,CBJ,C,79,1146.8,16,12.7,121,52,221,126,167,54,41
373,Kevin Bahl,N.J,D,42,588.85,2,7.41,30,1,79,27,47,32,20
374,Kevin Fiala,L.A,L,69,1214.066667,23,11.06,238,103,361,208,272,89,64
375,Kevin Gravel,NSH,D,23,328.1833333,0,0,16,3,51,20,29,22,9
376,Kevin Hayes,PHI,C,81,1422.816667,18,8.61,158,64,387,209,295,92,86
377,Kevin Labanc,S.J,R,72,1031.483333,15,11.63,141,51,251,129,173,78,44
378,Kevin Shattenkirk,ANA,D,75,1447.75,4,2.76,66,10,278,145,189,89,44
379,Kevin Stenlund,WPG,C,54,628.8333333,6,9.52,57,34,117,63,93,24,30
380,Kiefer Sherwood,NSH,L,32,434.9333333,7,12.28,57,27,103,57,79,24,22
381,Kieffer Bellows,"NYI, PHI",L,28,271.3333333,3,9.38,22,9,62,32,41,21,9
382,Kirby Dach,MTL,C,58,1072.75,14,13.08,120,69,185,107,151,34,44
383,Kirill Kaprizov,MIN,L,67,1414.55,40,15.33,304,119,498,261,370,128,109
384,Kirill Marchenko,CBJ,R,59,955.1666667,21,16.03,174,69,253,131,186,67,55
385,Klim Kostin,EDM,C,57,573.3833333,11,19.64,67,31,104,56,76,28,20
386,Kris Letang,PIT,D,64,1590.883333,12,7.45,109,19,374,161,225,149,64
387,Kurtis MacDermid,COL,D,44,366.6166667,1,5,12,4,51,20,28,23,8
388,Kyle Burroughs,VAN,D,48,833.4333333,2,4.26,26,4,92,47,59,33,12
389,Kyle Connor,WPG,L,82,1683.4,31,11.36,316,121,497,273,379,118,106
390,Kyle Okposo,BUF,R,75,1100.066667,11,7.33,138,65,241,150,190,51,40
391,Kyle Palmieri,NYI,C,55,940.4166667,16,13.11,168,76,240,122,184,56,62
392,Lane Pederson,"CBJ, VAN",C,27,322.0166667,3,11.11,30,19,45,27,36,9,9
393,Lars Eller,"COL, WSH",C,84,1242.516667,10,7.14,136,53,268,140,191,77,51
394,Laurent Dauphin,ARI,C,21,219.65,1,4,24,14,41,25,32,9,7
395,Lawrence Pilut,BUF,D,17,217.5333333,1,7.14,3,0,22,14,18,4,4
396,Lawson Crouse,ARI,L,77,1367.25,24,15.89,179,70,259,151,206,53,55
397,Leon Draisaitl,EDM,C,80,1738.716667,52,21.05,264,100,423,247,349,74,102
398,Liam Foudy,CBJ,C,62,752.35,7,10.45,81,40,130,67,98,32,31
399,Liam O'Brien,ARI,C,56,639.9,3,7.69,40,15,74,39,56,18,17
400,Libor Hajek,NYR,D,16,212.15,1,7.69,6,0,25,13,15,10,2
401,Logan Brown,STL,C,30,312.1,2,11.11,21,7,33,18,24,9,6
402,Logan Couture,S.J,C,82,1568.783333,27,13.57,229,121,342,199,279,63,80
403,Logan O'Connor,COL,R,82,1164.766667,9,8.65,127,68,197,104,153,44,49
404,Logan Stanley,WPG,D,19,260.5666667,1,9.09,8,1,38,11,22,16,11
405,Lucas Raymond,DET,L,74,1285.816667,17,12.69,152,72,245,134,174,71,40
406,Lukas Reichel,CHI,L,23,376.4333333,7,16.67,47,21,68,42,52,16,10
407,Lukas Sedlak,"COL, PHI",C,30,366.1333333,3,6.82,44,28,61,44,54,7,10
408,Luke Evangelista,NSH,R,24,397.75,7,12.96,58,33,78,54,61,17,7
409,Luke Glendening,DAL,C,70,844.3666667,3,4.62,86,46,136,65,108,28,43
410,Luke Kunin,S.J,C,31,478.3833333,5,8.62,67,33,99,58,83,16,25
411,Luke Schenn,"TOR, VAN",D,70,1144.833333,4,4.94,32,5,177,81,117,60,36
412,MacKenzie Entwistle,CHI,R,66,786.5166667,4,8,62,24,108,50,83,25,33
413,MacKenzie Weegar,CGY,D,81,1708.983333,4,2.5,101,17,356,160,229,127,69
414,Marc Staal,FLA,D,82,1491.883333,3,5.45,57,18,160,55,102,58,47
415,Marc-Edouard Vlasic,S.J,D,78,1362.7,1,1.49,59,17,179,67,114,65,47
416,Marco Rossi,MIN,C,19,237.95,0,0,22,11,28,13,21,7,8
417,Marco Scandella,STL,D,20,356.7,1,5.88,8,1,41,17,19,22,2
418,Marcus Bjork,CBJ,D,33,599.0333333,3,8.82,12,1,66,34,47,19,13
419,Marcus Foligno,MIN,L,65,974.4,7,8.43,100,55,153,83,124,29,41
420,Marcus Johansson,"MIN, WSH",L,80,1319.2,19,13.87,152,70,233,137,176,57,39
421,Marcus Pettersson,PIT,D,68,1399.7,1,1.04,69,19,216,96,149,67,53
422,Mario Ferraro,S.J,D,72,1555.433333,4,6.06,55,15,147,66,95,52,29
423,Mark Friedman,PIT,D,23,332.35,1,2.78,15,4,65,36,51,14,15
424,Mark Giordano,TOR,D,78,1478.133333,4,3.7,63,8,232,108,154,78,46
425,Mark Jankowski,NSH,C,50,621.9833333,7,12.28,69,34,106,57,81,25,24
426,Mark Kastelic,OTT,C,65,578.05,7,9.59,76,45,119,73,100,19,27
427,Mark Scheifele,WPG,C,81,1658.783333,42,20.39,277,135,363,206,301,62,95
428,Mark Stone,VGK,R,43,833.2,17,15.04,154,93,190,113,152,38,39
429,Markus Niemelainen,EDM,D,23,230.95,0,0,8,2,33,16,22,11,6
430,Martin Fehervary,WSH,D,67,1340.016667,6,6.59,71,25,189,91,124,65,33
431,Martin Kaut,"COL, S.J",R,36,374.45,4,9.09,48,18,88,44,66,22,22
432,Martin Necas,CAR,C,82,1509.8,28,11.67,242,82,438,240,349,89,109
433,Mason Appleton,WPG,C,41,656.7833333,5,7.04,61,35,109,71,93,16,22
434,Mason Marchment,DAL,L,68,1067.983333,12,8.11,173,75,264,148,210,54,62
435,Mason McTavish,ANA,C,80,1229.583333,17,10.56,163,83,269,161,216,53,55
436,Mason Shaw,MIN,C,59,666.1333333,7,7.61,58,27,153,92,114,39,22
437,Mathew Barzal,NYI,C,58,1085.533333,14,10.07,164,54,254,139,195,59,56
438,Mathieu Joseph,OTT,R,56,785.3666667,3,4.55,71,36,124,66,94,30,28
439,Mathieu Olivier,CBJ,R,66,767.6,5,6.67,82,54,139,75,108,31,33
440,Matias Maccelli,ARI,L,64,1003.616667,11,18.03,74,31,131,61,85,46,24
441,Mats Zuccarello,MIN,R,78,1575.1,22,11.11,197,72,381,198,279,102,81
442,Matt Boldy,MIN,L,81,1498.483333,31,12.16,271,96,486,255,379,107,124
443,Matt Duchene,NSH,C,71,1299.233333,22,13.1,194,70,319,168,239,80,71
444,Matt Dumba,MIN,D,79,1680.933333,4,4.04,75,17,258,99,160,98,61
445,Matt Grzelcyk,BOS,D,75,1292.5,4,3.92,49,7,201,102,149,52,47
446,Matt Irwin,WSH,D,61,795.3333333,2,2.53,30,9,140,79,102,38,23
447,Matt Martin,NYI,L,81,903.0333333,7,8.54,91,41,163,82,123,40,41
448,Matt Nieto,"COL, S.J",L,81,1095.5,12,10.43,113,60,174,115,147,27,32
449,Matt Roy,L.A,D,82,1539.616667,9,6.67,93,20,251,135,187,64,52
450,Matthew Benning,S.J,D,77,1522.95,1,1.72,52,7,156,58,87,69,29
451,Matthew Tkachuk,FLA,L,79,1614.433333,40,12.38,359,201,537,323,424,113,101
452,Mattias Ekholm,"EDM, NSH",D,78,1672.933333,9,6.67,90,26,286,135,196,90,61
453,Mattias Janmark,EDM,C,66,967.8166667,10,12.66,78,53,117,79,102,15,23
454,Mattias Samuelsson,BUF,D,55,1219.683333,2,2.63,31,8,138,76,103,35,27
455,Matty Beniers,SEA,C,80,1367.366667,24,16.22,157,78,270,148,218,52,70
456,Max Comtois,ANA,L,64,883.8666667,9,10.11,87,52,140,89,121,19,32
457,Max Domi,"CHI, DAL",C,80,1421.666667,20,11.17,172,70,323,179,243,80,64
458,Max Jones,ANA,L,69,877.2333333,9,8.41,120,62,185,107,142,43,35
459,Michael Amadio,VGK,"C, R",67,818.2333333,16,16.16,99,55,150,99,127,23,28
460,Michael Bunting,TOR,L,82,1295.35,23,13.22,222,129,298,174,253,45,79
461,Michael Eyssimont,"S.J, T.B, WPG",C,54,661.7,5,4.03,125,66,216,124,178,38,54
462,Michael McCarron,NSH,R,32,337.35,2,5.13,42,21,72,39,55,17,16
463,Michael McLeod,N.J,C,80,980.1333333,4,4.44,95,50,163,90,122,41,32
464,Michael Pezzetta,MTL,L,63,587.3166667,7,10,69,33,115,70,88,27,18
465,Michael Rasmussen,DET,C,56,845.4666667,10,11.36,112,68,150,88,121,29,33
466,Michael Stone,CGY,D,48,639.0333333,6,6.52,37,2,208,92,131,77,39
467,Mika Zibanejad,NYR,C,82,1636.9,39,15.54,230,94,440,251,368,72,117
468,Mikael Backlund,CGY,C,82,1489.366667,19,7.31,236,101,424,260,345,79,85
469,Mikael Granlund,"NSH, PIT",C,79,1406.95,10,8.26,141,70,222,121,172,50,51
470,Mike Hoffman,MTL,L,67,1050.133333,14,9.46,125,46,261,148,198,63,50
471,Mike Matheson,MTL,D,48,1173.683333,8,6.35,73,11,252,126,167,85,41
472,Mikey Anderson,L.A,D,77,1667.816667,5,5.56,78,15,188,90,132,56,42
473,Mikhail Sergachev,T.B,D,79,1881.066667,10,6.41,117,19,352,156,225,127,69
474,Mikko Rantanen,COL,R,82,1822.383333,55,17.92,310,115,559,307,428,131,121
475,Milan Lucic,CGY,L,77,870.6333333,7,9.59,88,50,144,73,109,35,36
476,Miles Wood,N.J,L,76,920.1333333,13,7.78,147,79,276,167,226,50,59
477,Miro Heiskanen,DAL,D,79,2013.8,11,5.34,156,23,441,206,281,160,75
478,Mitchell Marner,TOR,R,80,1702.1,30,15.31,200,62,402,196,262,140,66
479,Morgan Barron,WPG,C,70,928,8,7.14,121,63,183,112,150,33,38
480,Morgan Frost,PHI,C,81,1323.783333,19,12.26,180,91,277,155,206,71,51
481,Morgan Geekie,SEA,C,69,721.4,9,11.11,75,41,131,81,115,16,34
482,Morgan Rielly,TOR,D,65,1410.766667,4,3.17,91,19,242,126,174,68,48
483,Moritz Seider,DET,D,82,1898.2,5,3.57,67,6,297,140,201,96,61
484,Nate Schmidt,WPG,D,71,1311.183333,7,6.93,70,15,245,101,157,88,56
485,Nathan Bastian,N.J,R,43,534.7333333,6,9.68,80,58,102,62,89,13,27
486,Nathan Beaulieu,ANA,D,52,792.1333333,0,0,20,5,79,33,47,32,14
487,Nathan MacKinnon,COL,C,71,1584.533333,42,11.48,329,99,629,366,480,149,114
488,Nathan Walker,STL,L,56,575.9,2,4.65,48,21,78,43,59,19,16
489,Nazem Kadri,CGY,C,82,1411.116667,24,8.99,281,102,490,267,383,107,116
490,Neal Pionk,WPG,D,82,1799.15,10,7.04,66,15,296,142,215,81,73
491,Nic Dowd,WSH,C,65,867.8333333,13,20.97,74,37,108,62,84,24,22
492,Nicholas Paul,T.B,L,80,1292.733333,17,14.17,146,69,217,120,177,40,57
493,Nick Bjugstad,"ARI, EDM",C,78,1263.633333,17,11.72,164,82,247,145,211,36,66
494,Nick Blankenburg,CBJ,D,36,690.2666667,4,8,32,6,104,50,71,33,21
495,Nick Bonino,"PIT, S.J",C,62,986.7333333,10,10.99,102,55,148,91,118,30,27
496,Nick Cicek,S.J,D,16,230.6666667,0,0,11,1,21,3,6,15,3
497,Nick Cousins,FLA,C,79,871.0166667,9,8.74,103,49,175,103,136,39,33
498,Nick Foligno,BOS,L,60,741.9666667,10,14.08,75,42,116,71,97,19,26
499,Nick Holden,OTT,D,65,1085.966667,2,2.74,38,7,149,73,100,49,27
500,Nick Jensen,WSH,D,77,1587.483333,5,4.59,70,12,257,109,161,96,52
501,Nick Leddy,STL,D,78,1647.733333,2,2.53,55,8,164,79,118,46,39
502,Nick Perbix,T.B,D,69,1062.35,5,4.5,80,11,205,111,146,59,35
503,Nick Ritchie,"ARI, CGY",L,74,1002.566667,13,10.83,145,81,197,120,159,38,39
504,Nick Schmaltz,ARI,C,63,1241.683333,22,16.54,144,52,252,133,195,57,62
505,Nick Seeler,PHI,D,77,1115.7,4,4.76,42,13,164,84,109,55,25
506,Nick Suzuki,MTL,C,82,1729.833333,26,16.05,162,71,294,162,217,77,55
507,Nicklas Backstrom,WSH,C,39,658.25,7,11.86,75,38,118,59,80,38,21
508,Nico Hischier,N.J,C,81,1562.433333,31,12.06,290,161,418,257,343,75,86
509,Nico Sturm,S.J,C,74,1090.033333,14,11.67,110,59,194,120,165,29,45
510,Nicolas Aube-Kubel,"TOR, WSH",R,53,601.6666667,4,5.97,78,38,133,67,102,31,35
511,Nicolas Deslauriers,PHI,L,80,807.5333333,6,8.57,68,31,131,70,107,24,37
512,Nicolas Hague,VGK,D,81,1465.366667,3,2.91,63,9,248,103,158,90,55
513,Nicolas Roy,VGK,C,65,1059.4,14,13.86,131,82,178,101,139,39,38
514,Nikita Alexandrov,STL,C,28,274.7666667,3,10.71,29,19,43,28,40,3,12
515,Nikita Kucherov,T.B,R,82,1650.85,30,11.07,318,109,545,271,396,149,125
516,Nikita Zadorov,CGY,D,82,1532.233333,14,10.77,84,12,268,130,174,94,44
517,Nikita Zaitsev,"CHI, OTT",D,46,757.3333333,1,5,12,1,50,20,35,15,15
518,Niko Mikkola,"NYR, STL",D,81,1411.916667,1,1.61,30,3,127,62,91,36,29
519,Nikolaj Ehlers,WPG,L,45,704.1666667,12,9.09,135,38,293,132,207,86,75
520,Nils Aman,VAN,C,68,863.75,4,8,63,33,82,50,71,11,21
521,Nils Hoglander,VAN,L,25,301.3833333,3,10.34,34,9,58,29,40,18,11
522,Nils Lundkvist,DAL,D,60,978.5333333,6,6.38,50,9,195,94,129,66,35
523,Nino Niederreiter,"NSH, WPG",R,78,1270.366667,24,13.26,208,119,302,181,235,67,54
524,Noah Cates,PHI,L,82,1456.916667,13,12.15,150,79,198,107,151,47,44
525,Noah Dobson,NYI,D,78,1589.716667,13,6.31,116,16,481,206,309,172,103
526,Noah Gregor,S.J,C,57,739.5166667,10,8.4,134,60,204,119,168,36,49
527,Noah Hanifin,CGY,D,81,1833.983333,7,3.98,107,23,382,176,258,124,82
528,Noel Acciari,"STL, TOR",C,77,1102.083333,14,13.73,137,70,168,102,144,24,42
529,Oliver Bjorkstrand,SEA,R,81,1265.5,20,10.1,211,75,358,198,299,59,101
530,Oliver Ekman-Larsson,VAN,D,54,1089.5,2,2.22,51,5,197,90,127,70,37
531,Oliver Wahlstrom,NYI,R,35,425.8,7,10,77,24,140,70,97,43,27
532,Olli Maatta,DET,D,78,1459.15,6,9.68,32,3,137,62,92,45,30
533,Ondrej Palat,N.J,L,49,761.2333333,8,10.13,102,54,150,79,110,40,31
534,Oskar Lindblom,S.J,L,73,771.9,6,8,87,37,133,75,100,33,25
535,Oskar Sundqvist,"DET, MIN",C,67,928.9666667,10,14.49,88,55,125,69,97,28,28
536,Owen Power,BUF,D,79,1880.333333,4,3.08,100,26,228,130,160,68,30
537,Owen Tippett,PHI,R,77,1341.9,27,11.69,216,89,414,231,315,99,84
538,Parker Kelly,OTT,L,55,577.95,1,1.69,52,19,101,59,79,22,20
539,Pat Maroon,T.B,L,80,827.5833333,5,8.06,84,48,122,62,98,24,36
540,Patric Hornqvist,FLA,R,22,203.8833333,1,2.5,45,27,66,40,55,11,15
541,Patrice Bergeron,BOS,C,78,1356.55,27,10.84,300,134,437,249,339,98,90
542,Patrick Brown,"OTT, PHI",C,61,694.0333333,4,6.67,50,26,122,60,98,24,38
543,Patrick Kane,"CHI, NYR",R,73,1409.533333,21,9.25,175,53,371,227,296,75,69
544,Patrik Laine,CBJ,L,55,1051.65,22,11.96,155,43,359,184,268,91,84
545,Patrik Nemeth,ARI,D,75,1332.816667,0,0,37,7,139,62,94,45,32
546,Paul Cotter,VGK,C,55,705.4833333,13,17.11,88,44,131,76,95,36,19
547,Paul Stastny,CAR,C,73,866.5166667,9,11.25,109,74,137,80,120,17,40
548,Pavel Buchnevich,STL,L,63,1225.533333,26,21.14,154,67,227,123,181,46,58
549,Pavel Dorofeyev,VGK,L,18,256.15,7,17.5,45,24,68,40,49,19,9
550,Pavel Zacha,BOS,C,82,1316.583333,21,16.03,165,71,220,131,179,41,48
551,Peyton Krebs,BUF,C,74,1023.9,9,11.39,86,44,143,79,110,33,31
552,Phil Kessel,VGK,"C, R",82,1050.316667,14,9.4,157,56,261,149,199,62,50
553,Philip Broberg,EDM,D,46,579.7666667,1,3.13,23,5,72,32,43,29,11
554,Philip Tomasino,NSH,C,31,483.4166667,5,9.26,69,19,102,54,81,21,27
555,Philipp Kurashev,CHI,C,70,1219.433333,9,7.76,124,57,209,116,157,52,41
556,Phillip Danault,L.A,C,82,1502.65,18,11.76,165,74,252,153,203,49,50
557,Phillip Di Giuseppe,VAN,L,30,437.1333333,6,8.45,62,33,99,71,85,14,14
558,Pierre Engvall,"NYI, TOR",L,76,1036.4,17,12.88,140,65,249,132,180,69,48
559,Pierre-Edouard Bellemare,T.B,L,73,823.65,4,7.84,57,27,87,51,75,12,24
560,Pierre-Luc Dubois,WPG,L,73,1346.983333,27,13.17,263,149,380,205,308,72,103
561,Pierre-Olivier Joseph,PIT,D,75,1143.683333,5,4.63,66,7,221,108,138,83,30
562,Pius Suter,DET,C,79,1110.883333,14,13.21,112,59,178,106,145,33,39
563,Pontus Holmberg,TOR,R,37,385.5333333,5,18.52,36,14,49,27,41,8,14
564,Quinn Hughes,VAN,D,78,2001.566667,7,4.55,106,14,368,154,220,148,66
565,Quinton Byfield,L.A,C,53,745.3833333,3,4.05,92,56,145,74,119,26,45
566,Radek Faksa,DAL,C,81,1111.366667,11,12.5,97,62,141,88,120,21,32
567,Radim Simek,S.J,D,44,643.4333333,1,2.56,36,8,80,39,56,24,17
568,Radko Gudas,FLA,D,72,1249.983333,2,1.82,47,9,246,110,163,83,53
569,Rafael Harvey-Pinard,MTL,L,34,585.8,14,24.14,77,52,98,58,78,20,20
570,Rasmus Andersson,CGY,D,79,1902.866667,11,6.92,94,21,304,159,223,81,64
571,Rasmus Asplund,"BUF, NSH",C,46,504.2666667,2,3.7,43,27,76,54,68,8,14
572,Rasmus Dahlin,BUF,D,78,2011.933333,15,7.35,143,36,378,204,267,111,63
573,Rasmus Kupari,L.A,C,66,666.2666667,3,5.66,56,29,96,53,76,20,23
574,Rasmus Ristolainen,PHI,D,74,1407.783333,3,3.49,35,10,173,86,121,52,35
575,Rasmus Sandin,"TOR, WSH",D,71,1372.183333,7,8.64,57,10,174,81,110,64,29
576,Reese Johnson,CHI,C,57,627.65,4,7.41,47,20,90,54,73,17,19
577,Reilly Smith,VGK,R,78,1323.633333,26,14.44,197,80,311,180,242,69,62
578,Rem Pitlick,MTL,C,46,594.4333333,6,20,44,22,57,30,51,6,21
579,Rickard Rakell,PIT,R,82,1511.9,28,11.52,285,153,436,243,339,97,96
580,Ridly Greig,OTT,C,20,258.0333333,2,6.67,42,23,52,30,45,7,15
581,Riley Stillman,"BUF, VAN",D,50,732.1333333,1,2.7,17,6,105,37,61,44,24
582,Robby Fabbri,DET,C,28,447.95,7,20,44,21,65,35,53,12,18
583,Robert Bortuzzo,STL,D,43,540.3666667,2,6.67,15,4,59,30,42,17,12
584,Robert Hagg,DET,D,38,589.7833333,2,5,20,4,83,40,63,20,23
585,Robert Thomas,STL,C,73,1412.066667,18,16.98,119,52,175,106,144,31,38
586,Roman Josi,NSH,D,67,1686.2,18,6.69,197,41,542,269,357,185,88
587,Roope Hintz,DAL,C,73,1281.716667,37,20.11,225,121,316,184,252,64,68
588,Ross Colton,T.B,C,81,1000.45,16,10.46,169,84,269,153,216,53,63
589,Ryan Carpenter,NYR,C,22,201.8833333,1,5.88,20,11,30,17,25,5,8
590,Ryan Donato,SEA,C,71,799.05,14,11.48,120,60,203,122,156,47,34
591,Ryan Graves,N.J,D,78,1555.933333,8,5.67,89,14,290,141,183,107,42
592,Ryan Hartman,MIN,R,59,961.5833333,15,10.07,141,55,275,149,225,50,76
593,Ryan Johansen,NSH,C,55,865.7833333,12,13.95,118,64,154,86,128,26,42
594,Ryan Lindgren,NYR,D,63,1186.916667,1,1.33,54,13,159,75,101,58,26
595,Ryan Lomberg,FLA,L,82,927.3333333,12,8.96,121,67,218,134,189,29,55
596,Ryan McDonagh,NSH,D,71,1528.566667,2,2.56,60,14,178,78,121,57,43
597,Ryan McLeod,EDM,C,57,808.5833333,11,14.1,95,39,144,78,109,35,31
598,Ryan Nugent-Hopkins,EDM,C,82,1623.7,37,18.41,237,103,328,201,266,62,65
599,Ryan O'Reilly,"STL, TOR",C,53,950.7666667,16,15.69,119,59,163,102,130,33,28
600,Ryan Poehling,PIT,C,53,623.85,7,10.94,69,39,110,64,94,16,30
601,Ryan Pulock,NYI,D,82,1714.216667,5,3.97,76,6,301,126,185,116,59
602,Ryan Reaves,"MIN, NYR",R,73,680.4166667,5,10.42,54,36,79,48,69,10,21
603,Ryan Strome,ANA,C,82,1397.25,15,11.54,122,67,206,130,166,40,36
604,Ryan Suter,DAL,D,82,1671.116667,3,3.26,62,11,236,92,151,85,59
605,Saku Maenalanen,WPG,R,64,661.25,4,6.56,57,33,109,61,90,19,29
606,Sam Bennett,FLA,C,63,1096.633333,16,8.29,209,106,321,193,253,68,60
607,Sam Carrick,ANA,C,52,549.4,3,6,39,24,85,50,69,16,19
608,Sam Gagner,WPG,C,48,584.25,8,10.26,64,33,125,78,104,21,26
609,Sam Lafferty,"CHI, TOR",C,70,1022.6,12,11.76,100,42,164,102,135,29,33
610,Sam Reinhart,FLA,C,82,1622.05,31,13.66,290,170,407,227,330,77,103
611,Sam Steel,MIN,C,65,972.45,10,11.76,108,49,149,85,119,30,34
612,Sammy Blais,"NYR, STL",L,71,837.6333333,9,12.86,82,41,126,70,102,24,32
613,Samuel Bolduc,NYI,D,17,244.8333333,2,10,14,0,49,20,29,20,9
614,Samuel Girard,COL,D,76,1633.616667,6,5.04,80,16,269,119,156,113,37
615,Scott Harrington,"ANA, S.J",D,45,739.7166667,4,12.12,27,5,84,33,58,26,25
616,Scott Laughton,PHI,C,78,1426.233333,18,10.59,139,63,278,170,219,59,49
617,Scott Mayfield,NYI,D,82,1721.183333,6,5.04,71,14,296,119,173,123,54
618,Sean Durzi,L.A,D,72,1424.55,9,8.18,110,19,263,110,157,106,47
619,Sean Kuraly,CBJ,C,71,1070.216667,11,11,95,46,183,100,145,38,45
620,Sean Monahan,MTL,C,25,434.1833333,6,10.91,59,29,84,55,70,14,15
621,Sean Walker,L.A,D,70,1037.95,3,3.19,65,15,185,94,128,57,34
622,Sebastian Aho,CAR,C,75,1462.166667,36,16.51,251,145,377,218,311,66,93
623,Sebastian Aho,NYI,D,71,1190.7,5,5.62,50,8,183,89,131,52,42
624,Seth Jarvis,CAR,C,82,1328.683333,14,7.49,216,129,325,187,257,68,70
625,Seth Jones,CHI,D,72,1760.483333,12,6.74,96,22,330,178,242,88,64
626,Shane Pinto,OTT,C,82,1310.266667,20,12.66,194,93,269,158,221,48,63
627,Shayne Gostisbehere,"ARI, CAR",D,75,1561.25,13,8.39,98,18,334,155,230,104,75
628,Shea Theodore,VGK,D,55,1178.816667,8,5.88,80,16,282,136,183,99,47
629,Sheldon Dries,VAN,C,63,726.45,11,11.7,107,59,161,94,129,32,35
630,Sidney Crosby,PIT,C,82,1651.766667,33,12.94,269,144,443,255,348,95,93
631,Simon Benoit,ANA,D,78,1509.233333,3,3.66,45,7,175,82,120,55,38
632,Simon Holmstrom,NYI,R,50,554.8666667,6,15.38,59,17,77,39,59,18,20
633,Sonny Milano,WSH,L,64,826.05,11,13.75,89,54,142,80,123,19,43
634,Stefan Noesen,CAR,R,78,961.9333333,13,9.7,162,119,236,134,208,28,74
635,Steven Lorentz,S.J,C,80,946.6666667,10,9.01,126,66,191,111,151,40,40
636,Steven Stamkos,T.B,C,81,1540.683333,34,14.17,287,105,449,240,343,106,103
637,T.J. Oshie,WSH,R,58,969.9666667,19,15.08,173,94,228,126,187,41,61
638,Tage Thompson,BUF,"C, R",78,1449.9,47,15.93,299,120,542,295,410,132,115
639,Tanner Jeannot,"NSH, T.B",L,76,1083.233333,6,5.61,133,71,190,107,154,36,47
640,Tanner Laczynski,PHI,C,32,304.75,2,8.7,19,6,44,23,31,13,8
641,Taylor Hall,BOS,L,61,971.6833333,16,10.67,170,81,256,150,197,59,47
642,Taylor Raddysh,CHI,R,78,1292.3,20,15.5,142,84,224,129,181,43,52
643,Teddy Blueger,"PIT, VGK",C,63,813.3166667,4,4.71,81,54,128,85,105,23,20
644,Teuvo Teravainen,CAR,L,68,1149.8,12,8.33,122,41,235,144,195,40,51
645,Thomas Chabot,OTT,D,68,1698.116667,11,6.67,109,16,355,165,228,127,63
646,Tim Berni,CBJ,D,59,1000.9,1,1.72,43,10,119,58,73,46,15
647,Tim Stützle,OTT,L,78,1658.666667,39,17.11,276,111,442,228,322,120,94
648,Timo Meier,"N.J, S.J",R,78,1512.283333,40,12.2,368,155,600,328,465,135,137
649,Timothy Liljegren,TOR,D,67,1199.866667,6,7.14,50,8,154,84,110,44,26
650,TJ Brodie,TOR,D,58,1230.616667,2,3.45,30,7,101,58,74,27,16
651,Tom Wilson,WSH,R,33,581.3666667,13,15.85,85,51,141,82,110,31,28
652,Tomas Hertl,S.J,C,79,1523.216667,22,12.02,249,140,342,183,256,86,73
653,Tomas Nosek,BOS,L,66,828.4666667,7,10.14,70,34,112,69,92,20,23
654,Tomas Tatar,N.J,L,82,1239.6,20,13.07,196,104,276,153,215,61,62
655,Tommy Novak,NSH,C,51,747.3166667,17,18.28,102,34,159,93,121,38,28
656,Tony DeAngelo,PHI,D,70,1544.1,11,6.32,75,15,287,174,216,71,42
657,Torey Krug,STL,D,63,1170.766667,7,5.56,83,8,251,126,179,72,53
658,Travis Boyd,ARI,C,82,1355.483333,15,15.96,128,81,168,94,134,34,40
659,Travis Hamonic,OTT,D,75,1392.016667,6,4.41,62,11,277,136,180,97,44
660,Travis Konecny,PHI,R,60,1206.983333,31,16.23,207,88,358,191,272,86,81
661,Travis Sanheim,PHI,D,81,1652.616667,7,6.31,78,23,206,111,152,54,41
662,Trent Frederic,BOS,C,79,941.5,17,14.17,130,63,189,120,161,28,41
663,Trevor Lewis,CGY,C,82,993.7333333,9,6.25,109,52,224,144,188,36,44
664,Trevor Moore,L.A,"C, L",59,1002.316667,10,6.13,136,75,264,163,218,46,55
665,Trevor van Riemsdyk,WSH,D,75,1429.9,7,7.22,49,11,194,97,127,67,30
666,Trevor Zegras,ANA,C,81,1525,23,12.5,196,52,369,184,257,112,73
667,Troy Stecher,"ARI, CGY",D,81,1325.9,3,3.41,58,12,181,88,113,68,25
668,Troy Terry,ANA,R,70,1355.266667,23,12.23,247,109,352,188,283,69,95
669,Ty Dellandrea,DAL,C,82,1164.433333,9,9.78,110,46,174,92,134,40,42
670,Tyler Bertuzzi,"BOS, DET",L,50,824.4166667,8,7.48,110,59,181,107,145,36,38
671,Tyler Johnson,CHI,C,56,927.7166667,12,9.6,137,55,216,125,173,43,48
672,Tyler Motte,"NYR, OTT","C, L",62,779.5,8,7.34,105,58,184,109,140,44,31
673,Tyler Myers,VAN,D,78,1630.7,1,1,68,10,218,100,142,76,42
674,Tyler Pitlick,STL,C,61,614.6166667,7,12.96,60,27,96,54,79,17,25
675,Tyler Seguin,DAL,C,76,1262.933333,21,11.11,206,91,303,189,254,49,65
676,Tyler Toffoli,CGY,R,82,1362.1,34,12.69,254,91,477,268,365,112,97
677,Tyler Tucker,STL,D,26,380.6833333,1,4.76,12,1,54,21,27,27,6
678,Tyson Barrie,"EDM, NSH",D,85,1681.166667,13,7.98,75,17,329,163,220,109,57
679,Tyson Jost,"BUF, MIN",C,71,940.3,7,7.14,118,55,174,98,142,32,44
680,Urho Vaakanainen,ANA,D,23,378.5333333,0,0,13,1,58,27,40,18,13
681,Valeri Nichushkin,COL,R,53,1074.366667,17,10.76,168,83,257,158,210,47,52
682,Vasily Podkolzin,VAN,R,39,461.6666667,4,9.76,45,25,70,41,63,7,22
683,Victor Hedman,T.B,D,76,1802.65,9,4.86,133,17,397,185,284,113,99
684,Victor Olofsson,BUF,L,75,1076.633333,28,17.39,130,37,273,161,209,64,48
685,Victor Soderstrom,ARI,D,30,485.15,0,0,20,6,78,31,44,34,13
686,Viktor Arvidsson,L.A,"L, R",77,1316.4,26,11.4,236,89,418,228,315,103,87
687,Vince Dunn,SEA,D,81,1917.216667,14,9.33,103,11,335,150,226,109,76
688,Vincent Desharnais,EDM,D,36,487.65,0,0,17,0,48,17,27,21,10
